[console_scripts]
account-id = n_utils.cli:get_account_id
add-deployer-server = n_utils.cli:add_deployer_server
associate-eip = n_utils.cli:associate_eip
assume-role = n_utils.cli:assume_role
cf-follow-logs = n_utils.cli:tail_stack_logs
cf-get-parameter = n_utils.cli:get_parameter
cf-logical-id = n_utils.cli:logical_id
cf-logs-to-cloudwatch = n_utils.cli:logs_to_cloudwatch
cf-region = n_utils.cli:cf_region
cf-signal-status = n_utils.cli:signal_cf_status
cf-stack-id = n_utils.cli:stack_id
cf-stack-name = n_utils.cli:stack_name
cf-update-stack = n_utils.cli:update_stack
detach-volume = n_utils.cli:detach_volume
ec2-associate-eip = n_utils.cli:associate_eip
ec2-clean-snapshots = n_utils.cli:clean_snapshots
ec2-get-tag = n_utils.cli:tag
ec2-get-userdata = n_utils.cli:get_userdata
ec2-instance-id = n_utils.cli:instance_id
ec2-region = n_utils.cli:ec2_region
json-to-yaml = n_utils.cli:json_to_yaml
latest-snapshot = n_utils.volumes:latest_snapshot
list-file-to-json = n_utils.cli:list_file_to_json
logs-to-cloudwatch = n_utils.cli:logs_to_cloudwatch
mfa-add-token = n_utils.cli:cli_mfa_add_token
mfa-code = n_utils.cli:cli_mfa_code
mfa-delete-token = n_utils.cli:cli_mfa_delete_token
n-include = n_utils.cli:resolve_include
n-include-all = n_utils.cli:resolve_all_includes
n-utils-init = n_utils.cf_utils:init
ndt = n_utils.cli:ndt
nitor-dt-register-complete = n_utils.cli:ndt_register_complete
pytail = n_utils.cli:read_and_follow
signal-cf-status = n_utils.cli:signal_cf_status
yaml-to-json = n_utils.cli:yaml_to_json

